###################################
#                                 #
#                                 #
#                          #      #
#                         #  XX   #
#O                       #        #  
####################   ############  
#             #                   # 
#       P     #                   #  
#             #                   #   
#             ################    #                  
##########                   #    #   
#O                           #    #  
#                            #    #    
#          ###################    #                     
#                                 # 
#                                 #  
###################################